##.####.##
##########
.########.
##########
##.####.##
