#.#.##.#.#
.########.
##########
.########.
#.#.##.#.#
