...............
...............
...............
.......C.......
....###........
...........X...
...###.........
.......###.....
...........C...
..X............
.....###.......
..........###..
....C..........
.###.......###.
...............
...X......X....
......###......
............G..
S..............
###############
