.............G.
.......###.....
...X........X..
.....C.........
..###.....###..
...............
....X..###.....
.###.........#.
.........C.....
.....###....X..
..X........###.
.......###.....
...C...........
.###....###....
.............X.
...###.........
......C....###.
.X.............
S..............
###############
